荒野乱斗 | 闪耀暖暖 | 第五人格 | 梦幻西游 | 炉石传说 | 地下城与勇士 | 守望先锋 | 我的世界 | 英雄联盟 | 消消乐 | 
连连看 | 王者荣耀 | 和平精英 | 贪吃蛇大作战 | 阴阳师 | 旅行青蛙 | 恋与制作人 | 穿越火线 | 愤怒的小鸟 | 植物大战僵尸 | 
捕鱼达人 | 水果忍者 | 超级玛丽 | 打地鼠 | 俄罗斯方块 | 跑跑卡丁车 | 动物森友会 | 蚂蚁森林 | 撕名牌 | 健身环大冒险 | 
送人头 | 切水果 | 爆头 | 落地成盒 | 伏地魔 | 大吉大利 | 今晚吃鸡 | 三级甲 | 平底锅 | 空投 | 
狼人 | 亚瑟 | 大乔 | 小乔 | 妲己 | 蔡文姬 | 兰陵王 | 安琪拉 | 庄周 | 孙尚香 | 
抓娃娃 | 蹦床 | 漂流 | 狼人杀 | 剧本杀 | 密室逃脱 | 演唱会 | 跳舞机 | 广播体操 | 八块腹肌 | 
拔罐 | 泡温泉 | 钓鱼 | 跳伞 | 骑马 | 潜水 | 爬山 | 遛狗 | 攀岩 | 跑酷 | 
蹦极 | 冲浪 | 啦啦队 | 帽子戏法 | 中国足球 | 守门员 | 姚明 | 刘翔 | 林丹 | 李娜 | 
孙杨 | 宁泽涛 | 邹市明 | 郭晶晶 | 郎平 | 朱婷 | 张继科 | 马龙 | 易建联 | 乔丹 | 
科比 | 詹姆斯 | 韦德 | 奥尼尔 | 艾弗森 | 库里 | 梅西 | 贝克汉姆 | 年少有为 | 往后余生 | 
你笑起来真好看 | 成全 | 无价之姐 | 那些年 | 夏天的风 | 稻香 | 龙卷风 | 菊花台 | 听妈妈的话 | 蒲公英的约定 | 
等你下课 | 发如雪 | 断了的弦 | 青花瓷 | 千里之外 | 说好的幸福呢 | 背对背拥抱 | 那些你很冒险的梦 | 醉赤壁 | 突然好想你 | 
倔强 | 沙漠骆驼 | 王妃 | 平凡之路 | 芒种 | 泡沫 | 来自天堂的魔鬼 | 丑八怪 | 戒烟 | 像我这样的人 | 
消愁 | 惊雷 | 夜空中最亮的星 | 斑马斑马 | 追光者 | 卡路里 | 遇见 | 画心 | 易燃易爆炸 | 白羊 | 
爱笑的眼睛 | 爱情转移 | 红玫瑰 | 左手指月 | 贝加尔湖畔 | 身骑白马 | 风吹麦浪 | 阴天 | 天黑黑 | 绿光 | 
大城小爱 | 心中的日月 | 好心分手 | 你把我灌醉 | 我爱你中国 | 光年之外 | 我的滑板鞋 | 爱如潮水 | 老男孩 | 两只老虎 | 
分手快乐 | 小酒窝 | 隐形的翅膀 | 飞得更高 | 南山南 | 舞娘 | 同桌的你 | 月亮之上 | 桃花朵朵开 | 我的麦克风 | 
倒带 | 烟花易冷 | 断桥残雪 | 娃娃脸 | 天使的翅膀 | 棉花糖 | 你是我的眼 | 日不落 | 听海 | 狮子座 | 
蓝莲花 | 红日 | 狼爱上羊 | 纸短情长 | 达拉崩吧 | 那些年错过的爱情 | 来啊造作啊 | 菊花残满地伤 | 你的笑容已泛黄 | 我诗的每一页 | 
往后余生风雪是你 | 像春天的花一样 | 一起喵喵喵喵喵 | 心里的花 | 跟我一起画个龙 | 画一道彩虹 | 它永远不会堵车 | 相遇乱世以外 | 并决定跟她回家 | 谢谢你的成全 | 
确认过眼神 | 我遇上对的人 | 穿上一身帅气西装 | 你会在哪里 | 转眼都消散如烟 | 像影子追着光梦游 | 让音乐代替话语声 | 我深深的脑海里 | 鱼儿在你的荷塘 | 你说你有点难追 | 
全都是泡沫 | 左岸的咖啡 | 那些年错过的大雨 | 下一秒向你靠近 | 梦已准备就绪 | 拜拜甜甜圈 | 珍珠奶茶方便 | 喊出我的名字 | 黑着眼眶熬着夜 | 嘴唇像染着鲜血 | 
爱是一道光 | 爱的魔力转圈圈 | 爱就是泡沫 | 陪我春秋冬夏 | 在被子里的舒服 | 一杯敬朝阳 | 拿着爱的号码牌 | 你看这碗又大又圆 | 你看这面又长又宽 | 我应该在车底 | 
北风萧萧 | 终于看开爱回不来 | 我心中的棉花糖 | 看那桃花开 | 共享人世繁华 | 摇滚 | 嘻哈 | 民谣 | 古风 | 草莓音乐节 | 
乐队 | 鼓手 | 吉他手 | 新裤子 | 痛仰 | 反光镜乐队 | 动次打次 | 大话西游 | 流浪地球 | 中国机长 | 
让子弹飞 | 战狼 | 唐人街探案 | 疯狂的外星人 | 一吻定情 | 烈日灼心 | 一个勺子 | 大鱼海棠 | 中国女排 | 画皮 | 
小丑 | 釜山行 | 猫鼠游戏 | 指环王 | 悲伤逆流成河 | 功夫熊猫 | 海洋天堂 | 妖猫传 | 山楂树之恋 | 变形金刚 | 
复仇者联盟 | 绿皮书 | 海上钢琴师 | 黑天鹅 | 加勒比海盗 | 电锯惊魂 | 终结者 | 魂断蓝桥 | 机器人总动员 | 阿凡达 | 
泰坦尼克号 | 剪刀手爱德华 | 天使爱美丽 | 盗梦空间 | 爱情公寓 | 我是余欢水 | 小欢喜 | 长安十二时辰 | 都挺好 | 白夜追凶 | 
烈火如歌 | 旋风少女 | 一起来看流星雨 | 微微一笑很倾城 | 亮剑 | 家有儿女 | 还珠格格 | 少年包青天 | 天龙八部 | 一帘幽梦 | 
王子变青蛙 | 转角遇到爱 | 流星花园 | 公主小妹 | 放羊的星星 | 行尸走肉 | 破产姐妹 | 纸牌屋 | 冰与火之歌 | 吸血鬼日记 | 
黑镜 | 深夜食堂 | 鬼怪 | 来自星星的你 | 寄生虫 | 城市猎人 | 天国的阶梯 | 浪漫满屋 | 蓝色生死恋 | 蚂蚁竞走十年了 | 
鹿小葵加油 | 傅文佩快开门 | 你好骚啊 | 惊不惊喜 | 吃兔兔 | 声入人心 | 偶像练习生 | 拜托了冰箱 | 乐队的夏天 | 明星大侦探 | 
王牌对王牌 | 爸爸去哪儿 | 奔跑吧兄弟 | 奇葩说 | 中国新说唱 | 舌尖上的中国 | 熊出没 | 猫和老鼠 | 死亡笔记 | 名侦探柯南 | 
海贼王 | 犬夜叉 | 灌篮高手 | 网球王子 | 地狱少女 | 银魂 | 夏目友人帐 | 疯狂动物城 | 天空之城 | 神偷奶爸 | 
奥特曼 | 白素贞 | 皮卡丘 | 米奇 | 光头强 | 熊本熊 | 妙蛙种子 | 樱桃小丸子 | 假面骑士 | 龙猫 | 
小黄人 | 大白 | 屁桃 | 美人鱼 | 七个小矮人 | 佐助 | 乔巴 | 路飞 | 悲伤蛙 | 钢铁侠 | 
黑寡妇 | 雷神 | 鹰眼 | 朱朝阳 | 普普 | 严良 | 余欢水 | 韩商言 | 魏璎珞 | 魏无羡 | 
蓝忘机 | 张小敬 | 李必 | 洪世贤 | 艾莉 | 林品如 | 柳青 | 柳红 | 香妃 | 肖剑 | 
雪姨 | 可云 | 四郎 | 华妃 | 安陵容 | 沈眉庄 | 浣碧 | 大黄蜂 | 哈利波特 | 赫敏 | 
罗恩 | 金妮 | 邓布利多 | 海格 | 斯内普 | 小天狼星 | 三毛 | 黑白无常 | 七仙女 | 摸金校尉 | 
美国队长 | 蜘蛛侠 | 蝙蝠侠 | 绿巨人 | 金刚狼 | 蓝精灵 | 大头儿子 | 小头爸爸 | 大力水手 | 葫芦娃 | 
睡美人 | 白雪公主 | 匹诺曹 | 丑小鸭 | 一休 | 哪吒 | 吒儿 | 敖丙 | 太乙真人 | 小红帽 | 
风火轮 | 乾坤圈 | 小王子 | 盗墓笔记 | 下坠 | 老人与海 | 白夜行 | 追风筝的人 | 围城 | 三体 | 
月亮与六便士 | 骆驼祥子 | 白鹿原 | 呐喊 | 海底两万里 | 偷影子的人 | 射雕英雄传 | 神雕侠侣 | 鬼吹灯 | 莫言 | 
余华 | 海明威 | 欧亨利 | 郭敬明 | 韩寒 | 陈凯歌 | 张艺谋 | 冯小刚 | 社会摇 | 钢管舞 | 
肚皮舞 | 广场舞 | 脱衣舞 | 地板动作 | 天鹅舞 | 千手观音 | 宁静 | 伊能静 | 张雨绮 | 万茜 | 
沈梦辰 | 黄龄 | 张含韵 | 蓝盈盈 | 吴昕 | 杜华 | 秦昊 | 任嘉伦 | 何炅 | 刘雨昕 | 
孔雪儿 | 乃万 | 金子涵 | 希林娜依高 | 张艺凡 | 陈卓璇 | 翟天临 | 刘敏涛 | 朱一龙 | 肖战 | 
李现 | 程潇 | 蔡徐坤 | 陈立农 | 范丞丞 | 朱正廷 | 小鬼 | 王子异 | 孟美岐 | 吴宣仪 | 
赖美云 | 段奥娟 | 欧阳靖 | 毛不易 | 王源 | 王俊凯 | 郑云龙 | 杨紫 | 黄晓明 | 陈冠希 | 
谢霆锋 | 罗志祥 | 吴亦凡 | 鹿晗 | 欧阳娜娜 | 宋祖儿 | 撒贝宁 | 池子 | 金婧 | 贾玲 | 
杨迪 | 岳云鹏 | 张云雷 | 郭德纲 | 沈腾 | 周冬雨 | 大张伟 | 王一博 | 华晨宇 | 迪丽热巴 | 
邓紫棋 | 李小璐 | 林俊杰 | 周杰伦 | 黄子韬 | 张艺兴 | 孙红雷 | 黄渤 | 腾格尔 | 刘欢 | 
周深 | 权志龙 | 金智妮 | 泫雅 | 边伯贤 | 朴灿烈 | 姜丹尼尔 | 金高银 | 孔刘 | 火箭少女 | 
防弹少年团 | 羽泉 | 小黄鸭 | 霉霉 | 四字弟弟 | 刘壮实 | 矮大紧 | 四千年美女 | 现男友 | 四叶草 | 
小飞象 | 川建国 | 博君一肖 | 开源 | 云次方 | 小助理 | 冯提莫 | 郭老师 | 毛毛姐 | 乔碧萝 | 
周扬青 | 张大奕 | 钟美美 | 李子柒 | 王健林 | 王思聪 | 罗永浩 | 马化腾 | 罗胖 | 初音未来 | 
洛天依 | 紧箍咒 | 轻功 | 点穴 | 芭蕾舞 | 提线木偶 | 安塞腰鼓 | 川剧变脸 | 舞狮 | 扭秧歌 | 
京剧 | 顶碗 | 踩高跷 | 钻火圈 | 喷火 | 愚公移山 | 何时复西归 | 长风破浪会有时 | 月有阴晴圆缺 | 起舞弄清影 | 
醉里挑灯看剑 | 了却君王天下事 | 乱花渐欲迷人眼 | 大漠孤烟直 | 采菊东篱下 | 春蚕到死丝方尽 | 隔江犹唱后庭花 | 沉舟侧畔千帆过 | 小桥流水人家 | 断肠人在天涯 | 
落红不是无情物 | 天涯若比邻 | 关关雎鸠在河之洲 | 李清照 | 李白 | 杜甫 | 陶渊明 | 辛弃疾 | 施耐庵 | 罗贯中 | 
曹雪芹 | 吴承恩 | 后羿射日 | 八仙过海 | 夸父逐日 | 大禹治水 | 天狗食月 | 嫦娥奔月 | 牛郎织女 | 女娲补天 | 
青蛙王子 | 岳飞 | 廉颇 | 鸡犬升天 | 钻木取火 | 闻鸡起舞 | 虎头蛇尾 | 水滴石穿 | 海底捞月 | 鲤鱼跳龙门 | 
骑驴找马 | 鹤立鸡群 | 悬崖勒马 | 盲人摸象 | 掩耳盗铃 | 死不瞑目 | 对牛弹琴 | 开门见山 | 丰乳肥臀 | 猴子捞月 | 
左拥右抱 | 童颜巨乳 | 闭月羞花 | 花天酒地 | 借花献佛 | 一针见血 | 小鸟依人 | 顺手牵羊 | 挥汗如雨 | 金鸡独立 | 
鸡同鸭讲 | 坐井观天 | 鸡飞狗跳 | 三头六臂 | 天猫 | 豆瓣 | 小红书 | 今日头条 | 印象笔记 | 百度网盘 | 
大众点评 | 京东 | 得物 | 新氧 | 贝壳找房 | 小破站 | 热搜榜 | 红包群 | 绿码 | 表情包 | 
拍了拍 | 录屏 | 撩骚 | 我酸了 | 我柠檬了 | 我不要你觉得 | 夜光剧本 | 做头发 | 锁了 | 哭晕在厕所 | 
冲鸭 | 硬核 | 道路千万条 | 亲人两行泪 | 泪目 | 注入灵魂 | 盘它 | 月光剧本 | 一胖毁所有 | 猛女落泪 | 
猛虎落泪 | 天使女孩 | 叫爸爸 | 死亡凝视 | 发际线癌 | 你的魔鬼来咯 | 家里有矿 | 求生欲 | 送命题 | 续命 | 
不知妻美 | 好嗨呦 | 到达了巅峰 | 梁静茹给的勇气 | 全靠同行衬托 | 你的文字还爱他 | 意难平 | 奇怪的知识增加了 | 还我血汗钱 | 灵魂拷问 | 
拔草 | 慎入 | 躺平任嘲 | 白嫖 | 错过一个亿 | 游泳健身了解一下 | 江南皮革厂 | 黄鹤 | 捧场王 | 给里给气 | 
可攻可受 | 痴汉 | 接盘侠 | 猪猪女孩 | 小奶狗 | 小狼狗 | 舔狗 | 偷鸡贼 | 小学鸡 | 臭弟弟 | 
小哥哥 | 总裁夫人 | 十八线 | 卖茶女 | 拖油瓶 | 负心汉 | 蜈蚣精 | 纸片人 | 白切黑 | 天然呆 | 
萝莉 | 御姐 | 伪娘 | 腹黑 | 秃头小宝贝 | 爆炸头 | 背头 | 定型喷雾 | 公主切 | 黑长直 | 
空气刘海 | 绵羊卷 | 奶奶灰 | 染发膏 | 三七分 | 双马尾 | 秃顶 | 渣男烫 | 锡纸烫 | 长发及腰 | 
中分 | 自然卷 | 大金链子 | 大头皮鞋 | 吊带袜 | 洞洞鞋 | 老爹鞋 | 网袜 | 腋下包 | 渔夫帽 | 
阔腿裤 | 马丁靴 | 脸基尼 | 电动牙刷 | 贴面膜 | 双眼皮贴 | 涂口红 | 姨妈红 | 斩男色 | 抽脂 | 
割双眼皮 | 祛斑 | 打瘦脸针 | 脱毛 | 整容 | 盲人按摩 | 腹肌 | 平板支撑 | 深蹲 | 仰卧起坐 | 
引体向上 | 马甲线 | 人鱼线 | 腿毛 | 腋毛 | 美甲 | 草莓鼻 | 大饼脸 | 斗鸡眼 | 嘟嘟唇 | 
法令纹 | 国字脸 | 虎牙 | 假发 | 金发碧眼 | 香肠嘴 | 小鸡嘴 | 血盆大口 | 鼻毛 | 便秘 | 
肚腩 | 发际线 | 黑头 | 门牙 | 吻痕 | 锥子脸 | 喉结 | 耳屎 | 西安摔碗酒 | 大唐不倒翁 | 
自由女神像 | 女仆餐厅 | 抢银行 | 设计师 | 按摩师 | 拔罐师 | 调酒师 | 体育老师 | 瑟瑟发抖 | 爆肝 | 
头秃 | 气到吐血 | 湿身 | 姨母笑 | 微笑 | 挑眉 | 开心 | 难过 | 疑惑 | 舌吻 | 
吃屎 | 跪舔 | 反手涂口红 | 口红试色 | 抓老鼠 | 吸猫 | 撩妹 | 撒钱 | 扑倒 | 车震 | 
滚床单 | 裤裆藏雷 | 食人鱼 | 富婆快乐球 | 小浣熊干脆面 | 黑森林蛋糕 | 奶油蘑菇汤 | 肉松小贝 | 奶盖茶 | 小嘴抹了蜜 | 
身体却很诚实 | 犹抱琵琶半遮面 | 安利 | 滴眼药水 | 翻跟头 | 萝卜蹲 | 砍头 | 尿裤子 | 摔手机 | 吹泡泡 | 
报警 | 洗袜子 | 升旗 | 潜规则 | 老干妈 | 奈雪的茶 | 一点点 | 蜜雪冰城 | 大嘴猴 | 川久保玲 | 
彪马 | 匡威 | 中国李宁 | 大白鹅 | 孔雀 | 卢勇海 | 